#Please keep tags sorted alphabetically when you add/remove country tags

# Special countries...
REB = "countries/Rebels.txt"                                    # 1
OMG = "countries/OMG.txt"                                       # 2

# The Important Majors!
GER	= "countries/Germany.txt"                                   # 3
ENG	= "countries/United Kingdom.txt"                            # 4
SOV	= "countries/Soviet Union.txt"                              # 5
USA	= "countries/USA.txt"                                       # 6
JAP	= "countries/Japan.txt"                                     # 7
FRA	= "countries/France.txt"                                    # 8
ITA	= "countries/Italy.txt"                                     # 9

# Northern Europe
DEN	= "countries/Denmark.txt"                                   # 10
ICL	= "countries/Iceland.txt"                                   # 11
EST	= "countries/Estonia.txt"                                   # 12
FIN	= "countries/Finland.txt"                                   # 13
LAT	= "countries/Latvia.txt"                                    # 14
LIT	= "countries/Lithuania.txt"                                 # 15
NOR	= "countries/Norway.txt"                                    # 16
SWE	= "countries/Sweden.txt"                                    # 17

# Western Europe
BEL	= "countries/Belgium.txt"                                   # 18
HOL	= "countries/Netherlands.txt"                               # 19
IRE	= "countries/Ireland.txt"                                   # 20
LUX	= "countries/Luxemburg.txt"                                 # 21
VIC	= "countries/Vichy France.txt"                              # 22

# Central Europe
AUS	= "countries/Austria.txt"                                   # 23
CZE	= "countries/Czechoslovakia.txt"                            # 24
CRO	= "countries/Croatia.txt"                                   # 25
HUN	= "countries/Hungary.txt"                                   # 26
POL	= "countries/Poland.txt"                                    # 27
ROM	= "countries/Romania.txt"                                   # 28
SLO	= "countries/Slovakia.txt"                                  # 29
SCH	= "countries/Switzerland.txt"                               # 30

# Southern Europe
MTA	= "countries/Malta.txt"                                     # 31
POR	= "countries/Portugal.txt"                                  # 32
RSI	= "countries/Italian Social Republic.txt"                   # 33
SPA	= "countries/Nationalist Spain.txt"                         # 34
SPR	= "countries/Republican Spain.txt"                          # 35

# Southeast Europe
ALB	= "countries/Albania.txt"                                   # 36
BUL	= "countries/Bulgaria.txt"                                  # 37
GRE	= "countries/Greece.txt"                                    # 38
YUG	= "countries/Yugoslavia.txt"                                # 39

# Reichkommissariat
RKO	= "countries/Reichkommissariat Ostland.txt"                 # 40
RKU	= "countries/Reichkommissariat Ukraine.txt"                 # 41
RKM	= "countries/Reichkommissariat Moskowien.txt"               # 42
RKK	= "countries/Reichkommissariat Kaukasien.txt"               # 43
RUR	= "countries/Reichkommissariat Ural.txt"                    # 44

# Western Asia
AFG	= "countries/Afghanistan.txt"                               # 45
IRQ	= "countries/Iraq.txt"                                      # 46
ISR	= "countries/Israel.txt"                                    # 47
JOR	= "countries/Jordan.txt"                                    # 48
LEB	= "countries/Lebanon.txt"                                   # 49
OMN	= "countries/Oman.txt"                                      # 50
PAL	= "countries/Palestine.txt"                                 # 51
PER	= "countries/Persia.txt"                                    # 52
SAU	= "countries/Saudi Arabia.txt"                              # 53
SYR	= "countries/Syria.txt"                                     # 54
TUR	= "countries/Turkey.txt"                                    # 55
YEM	= "countries/Yemen.txt"                                     # 56

# Southern Asia
BHU	= "countries/Bhutan.txt"                                    # 57
IND	= "countries/India.txt"                                     # 58
NEP	= "countries/Nepal.txt"                                     # 59
PAK	= "countries/Pakistan.txt"                                  # 60
BBU	= "countries/British Burma.txt"                             # 61

# Eastern Asia
CGX	= "countries/Guangxi Clique.txt"                            # 61
CHC	= "countries/Communist China.txt"                           # 62
CHI	= "countries/Nationalist China.txt"                         # 63
CSX	= "countries/Shanxi.txt"                                    # 64
CXB	= "countries/Xibei San Ma.txt"                              # 65
CYN	= "countries/Yunnan.txt"                                    # 66
KOR	= "countries/Korea.txt"                                     # 67
MAN	= "countries/Manchukuo.txt"                                 # 68
MEN	= "countries/Mengkukuo.txt"                                 # 69
MON	= "countries/Mongolia.txt"                                  # 70
NJG = "countries/Republic of China-Nanjing.txt"                 # 71
SIK	= "countries/Sinkiang.txt"                                  # 72
TAN	= "countries/Tannu Tuva.txt"                                # 73
TIB	= "countries/Tibet.txt"                                     # 74

# Southeastern Asia
IDC	= "countries/Indochina.txt"                                 # 75
INO	= "countries/Indonesia.txt"                                 # 76
PHI	= "countries/Philippines.txt"                               # 77
SIA	= "countries/Siam.txt"                                      # 78

# Africa
EGY	= "countries/Egypt.txt"                                     # 79
LIB	= "countries/Liberia.txt"                                   # 80
ETH	= "countries/Ethiopia.txt"                                  # 81
SAF	= "countries/South Africa.txt"                              # 82

# Australasia
AST	= "countries/Australia.txt"                                 # 83
NZL	= "countries/New Zealand.txt"                               # 84
PAP = "countries/Papua New Guinea.txt"                          # 85

# Northern America
CAN	= "countries/Canada.txt"                                    # 86
CUB	= "countries/Cuba.txt"                                      # 87
COS	= "countries/Costa Rica.txt"                                # 88
DOM	= "countries/Dominican Republic.txt"                        # 89
GUA	= "countries/Guatemala.txt"                                 # 90
HAI	= "countries/Haiti.txt"                                     # 91
HON	= "countries/Honduras.txt"                                  # 92
MEX	= "countries/Mexico.txt"                                    # 93
NIC	= "countries/Nicaragua.txt"                                 # 94
PAN	= "countries/Panama.txt"                                    # 95
SAL	= "countries/El Salvador.txt"                               # 96

# Southern America
ARG	= "countries/Argentina.txt"                                 # 97
BOL	= "countries/Bolivia.txt"                                   # 98
BRA	= "countries/Brazil.txt"                                    # 99
CHL	= "countries/Chile.txt"                                     # 100
COL	= "countries/Colombia.txt"                                  # 101
ECU	= "countries/Ecuador.txt"                                   # 102
PAR	= "countries/Paraguay.txt"                                  # 103
PRU	= "countries/Peru.txt"                                      # 104
URU	= "countries/Uruguay.txt"                                   # 105
VEN	= "countries/Venezuela.txt"                                 # 106